Arbitrary Evaluations
An Interactive Fiction by Louis Ades
Release 1 / Serial number 140317 / Inform 7 build 6G60 (I6/v6.32 lib 6/12N) SD

Testing Chamber
You find yourself in a room that takes on the appearance of a test chamber. All there is are two doors along the walls, and a small crate lying in the center of the room. On the southern wall, "1:00 AM" is painted to fill up nearly the whole wall. There is silence. Suddenly, you hear over a loudspeaker, "Ah, another test subject! Welcome! You don't know who I am, but I know everything there is to know about you." Perhaps we should keep it that way. You're objective is to get out of here and find me. How will you do that? Well, heheh, I can't tell you that. But maybe you shouldn't try to figure it out right now...maybe you should just sit down...and relax...and rest...heheheheh...oh, and just for your reference, it's currently midnight." The voice cuts out. Suddenly, you hear the audible sounds of the air ventilation system speeding up outside of the room. A strange yellow-colored gas fills the room. After some time, you feel it fill your lungs, and you cough a bit. You are left alone in the room.

You can see a Challenge Door, a True Door and a crate (closed) here.

>Look
Testing Chamber

>open crate
You can't see any such thing.

>crate
That's not a verb I recognise.

>Showme
Testing Chamber - room
    yourself - person

* * *

>open crate
You open the crate, revealing a wooden Challenge Key.

>showme
Testing Chamber - room
    yourself - person
    crate - open container

* * *

>open crate
You open the crate, revealing a wooden Challenge Key.

>take wooden Challenge Key
Taken.

>showme
Testing Chamber - room
    yourself - person
        wooden Challenge Key
    crate - open container

>open True Door
You can't see any such thing.

* * *

>open crate
You open the crate, revealing a wooden Challenge Key.

>rest
You rest for 10 minutes. The time of day is   now 12:11 am

* * *

>open crate
You open the crate, revealing a wooden Challenge Key.

>not resting
That's not a verb I recognise.

>rest
You rest for 10 minutes. The time of day is now 12:11 am

>take key
Taken.

>unlock Challenge Door
(with the wooden Challenge Key)
You unlock the Challenge Door.

* * *

>open crate
You open the crate, revealing a wooden Challenge Key.

>take key
Taken.

You begin to feel woozy, and your vision blurs for a second, but then you feel normal again.

>unlock Challenge Door
(with the wooden Challenge Key)
Your health decreased by 1.

You unlock the Challenge Door.

* * *

>take key
Taken.

You begin to feel woozy, and your vision blurs for a second, but then you feel normal again.

>unlock door
(with the wooden Challenge Key)
You unlock the Challenge Door.

* * *

>take key
Taken.

You begin to feel woozy, and your vision blurs for a second, but then you feel normal again.

>rest
You rest for 10 minutes. The time of day is   now 12:12 am
A stinging pain hits your throat, and you begin to cough violently.

* * *

>take key
Taken.

You begin to feel woozy, and your vision blurs for a second, but then you feel normal again.

>unlock challenge door
(with the wooden Challenge Key)
You unlock the Challenge Door.

>say "Hi"
(to yourself)
There is no reply.

A stinging pain hits your throat, and you begin to cough violently.

>enter Challenge Door
(first opening the Challenge Door)

First Riddle Room
You can see a Challenge Door and Kinder Gardener here.

>say "Hi"
(to Kinder Gardener)
There is no reply.

* * *

>open crate
You open the crate, revealing a wooden Challenge Key.

>unlock challenge door
What do you want to unlock the Challenge Door with?

>challenge key
(first taking the wooden Challenge Key)
You unlock the Challenge Door.

You begin to feel woozy, and your vision blurs for a second, but then you feel normal again.

>enter challenge door
(first opening the Challenge Door)

First Riddle Room
You can see a Challenge Door and Kinder Gardener here.

* * *

>unlock challenge door
What do you want to unlock the Challenge Door with?

>key
(first taking the wooden Challenge Key)
You unlock the Challenge Door.

You begin to feel woozy, and your vision blurs for a second, but then you feel normal again.

>enter Challenge Door
(first opening the Challenge Door)

First Riddle Room
You can see a Challenge Door and Kinder Gardener here.

* * *

>key
(first taking the wooden Challenge Key)
You unlock the Challenge Door.

You begin to feel woozy, and your vision blurs for a second, but then you feel normal again.

>enter challenge door
(first opening the Challenge Door)

First Riddle Room
You can see a First Riddle Door, a Challenge Door, Kinder Gardener, Box #1 (closed), Box #2 (closed), Box #3 (closed), Box #4 (closed) and Box #5 (closed) here.

Once in the First Riddle Room, the strange voice says, "Oh, I'm not sure if I'd like you to take on this challenge--you may hurt yourself, after all. But if you insist, you must know that each room contains a riddle that you'll need to solve. Solve it, and the door connecting to the next room will unlock. It's very possible that there is an end to this maze after, possibly, the seventh room. Will it lead you to safety? It looks like you'll have to find that out yourself. If it were up to me, I wish you'd just sit down...and rest...but regardless, try not to hurt yourself, heheheh." The loudspeaker cuts out.
A man stands in the center of the room in a white button-down, khaki pants, and a large name tag with the name written, "Kinder Gardener". He says as you approach him, "I really wish you wouldn't try this door, but if you insist, two plus two must equal...". There are five closed boxes in front of him, each with a button on the top that opens it.

[Your score has just gone up by five points.]

>open crate #4
You can't see any such thing.

>open Box #4
You open Box #4, revealing a First Riddle Key.

>take first riddle key
Taken.

>unlock first riddle door
What do you want to unlock the First Riddle Door with?

>first riddle key
You unlock the First Riddle Door.

Once again, the gas hasn't felt that impactful to your health, but your previous symptoms get stronger, and you start to feel hyperthermia.

>enter first riddle door
(first opening the First Riddle Door)

Second Riddle Room
You can see a Red Door, a Green Door, a Blue Door, a First Riddle Door, Mindasa Gasho and Wendy Gasho here.

Two women stand side by side in the next room. To the north is a blue door, to the east is a green door, and to the south is a red door (the door you entered through is to the west). Both are dressed identically, in black button-down blouses, white sports jackets and white pants. The woman on the left has blond hair and wears a name tag that says, "Mindasa". The woman on the right has brown hair and wears a name tag that says, "Wendy." Other than these differences, both are nearly identical in every way. Both women say, perfectly in unison, "Welcome to the second room! We're so ecstatic you made it through the first riddle! It was designed for kindergarteners, so we wouldn't expect any less from you! And don't worry, this one won't be nearly as deadly if you fail. Simply FOLLOW OUR INSTRUCTIONS EXACTLY to find out which door to enter through, and you will make it to the next room in this wondrous maze!"

 Mindasa recites, in such monotony that she could be mistaken for an android, "There is a zero percent chance that you'll want to follow me if your intention is to pass through to what will be the wrong room. But then again, I have been known to lie one hundred percent of the time." Mindasa then turns her back towards you and walks towards the blue door to the north. She opens it, walks through, and closes it behind her.

 Wendy recites, in an identical tone and voice, "Mindasa is correct, and I will lead you to the right room room. One of these two things I just said is a lie, but this following statement is absolutely true: there is only one correct room." Wendy then turns her back towards you and walks towards the green door to the east. She opens it, walks through, and closes it behind her.

[Your score has just gone up by five points.]

>enter red door
(first opening the Red Door)

Room of Despair
You can see a Silver Staircase, a White Door, a Red Door and a bed here.

A stinging pain hits your throat, and you begin to cough violently.

You overhear the creepy voice on the loadspeaker say, in his usual calm and overbearing voice, "Congratulations. While your first test may have been straightforward, this one required you to think...outside the box. Now, why don't you take a break on this nice bed in front of you? I can't think of any harm in taking a rest in the Room of Despair, after all...heheheh." The room is lighted to a very strange degree, giving off a creepy tone throughout the room. At the other end of the room is a white door.

[Your score has just gone up by five points.]

>enter red door
Second Riddle Room
You can see a Red Door, a Green Door, a Blue Door and a First Riddle Door here.

>enter red door
Room of Despair
You can see a Red Door, a Silver Staircase, a White Door and a bed here.

>enter white door
(first opening the White Door)

Nightmare Room
You can see a Blood Door and a White Door here.

As you enter the room, labeled by the White Door as the "Nightmare Room," the fluorescent lights in the room begin to dim, and then suddenly black out. The sound of air pressure filling the air vents begins to sound. You notice as you keep breathing, that there is something in the air of this room. You begin to trip, and stumble. Suddenly, images on the walls begin to shine out of the black. They are writing scribbled in what looks to be blood dripping down to the ground. The writings get filled in and become legible in front of your eyes..."KCABNRUT" is what is written, over and over again on these walls. The words begin to cascade, until all you can see are the walls completely painted in blood, and the words "KCABNRUT" inscribed in gigantic letters, crooked and slanted as they line the ceiling, the only slate not left completely filled. 
 
 Suddenly, two lights turn back on, one in front of a blood red door right in front of you, and another lighting up the white door right behind you.

[Your score has just gone up by five points.]

>enter white door
Room of Despair
You can see a White Door, a Red Door and a Silver Staircase here.

Your stomach suddenly feels inflamed. This disease is catching up on you. You get sick and stumble to the floor. You pick yourself back up, but you begin to feel yourself weakening.

As you desperately TURN BACK and as the walls instruct, you jolt right back to where you last left off, the Room of Despair. But something is different; the bed has disappeared, and you notice that the Silver Staircase is no longer locked.

[Your score has just gone up by five points.]

>enter silver staircase
(first opening the Silver Staircase)

Yellow Room
You can see a Wooden Door and a Silver Staircase here.

You walk up the silver staircase. You enter an empty, yellow room. Nothing is in the room except a plain wooden door at the other end, and the silver staircase you just walked up.

>enter wooden door
(first opening the Wooden Door)

Dead End
You can see a Silver Door and a Wooden Door here.

You walk into the next room. There is nothing in it. There's a silver door at the other end, but it is locked. White fluorescent light fills the room, almost blinding compared to the much dimmer light in the yellow room. The strange voice comes back on-line. You can hear disgust in his tone as he says, "Hmph, it seems you've reached the dead end. That's a shame--I had hoped you would be able to make it further. And for all the help I tried to *lend* you. Oh well--the next test subject should be here soon. You should be dead from your illness soon enough. Just don't leave a mess for the next subject." The voice cuts out. There is a deadening silence in the room.

>enter wooden door
Yellow Room
You can see a Wooden Door and a Silver Staircase here.

You walk up the silver staircase. You enter an empty, yellow room. Nothing is in the room except a plain wooden door at the other end, and the silver staircase you just walked up.

>enter wooden door
Dead End
You can see a Wooden Door and a Silver Door here.

Your vision begins to blur, but this time it doesn't go away. You can still see ahead of you, but just barely. Your muscles weaken, and every further movement requires limping.

You walk into the next room. There is nothing in it. There's a silver door at the other end, but it is locked. White fluorescent light fills the room, almost blinding compared to the much dimmer light in the yellow room. The strange voice comes back on-line. You can hear disgust in his tone as he says, "Hmph, it seems you've reached the dead end. That's a shame--I had hoped you would be able to make it further. And for all the help I tried to *lend* you. Oh well--the next test subject should be here soon. You should be dead from your illness soon enough. Just don't leave a mess for the next subject." The voice cuts out. There is a deadening silence in the room.

* * *

>open crate
You open the crate, revealing a wooden Challenge Key.

>unlock door
Which do you mean, the Challenge Door or the True Door?

>key
(first taking the wooden Challenge Key)
You unlock the Challenge Door.

You begin to feel woozy, and your vision blurs for a second, but then you feel normal again.

>enter challenge door
(first opening the Challenge Door)

First Riddle Room
You can see a First Riddle Door, a Challenge Door, Kinder Gardener, Box #1 (closed), Box #2 (closed), Box #3 (closed), Box #4 (closed) and Box #5 (closed) here.

Once in the First Riddle Room, the strange voice says, "Oh, I'm not sure if I'd like you to take on this challenge--you may hurt yourself, after all. But if you insist, you must know that each room contains a riddle that you'll need to solve. Solve it, and the door connecting to the next room will unlock. It's very possible that there is an end to this maze after, possibly, the seventh room. Will it lead you to safety? It looks like you'll have to find that out yourself. If it were up to me, I wish you'd just sit down...and rest...but regardless, try not to hurt yourself, heheheh." The loudspeaker cuts out.
A man stands in the center of the room in a white button-down, khaki pants, and a large name tag with the name written, "Kinder Gardener". He says as you approach him, "I really wish you wouldn't try this door, but if you insist, two plus two must equal...". There are five closes crates in front of him.

>open box #1
You open Box #1.

A stinging pain hits your throat, and you begin to cough violently.

    *** You died. ***

In that game you scored 0 out of a possible 0, in 4 turns.

Would you like to RESTART, RESTORE a saved game, QUIT or UNDO the last command?

* * *

>key
(first taking the wooden Challenge Key)
You unlock the Challenge Door.

You begin to feel woozy, and your vision blurs for a second, but then you feel normal again.

>enter door
(first opening the Challenge Door)

First Riddle Room
You can see a First Riddle Door, a Challenge Door, Kinder Gardener, Box #1 (closed), Box #2 (closed), Box #3 (closed), Box #4 (closed) and Box #5 (closed) here.

Once in the First Riddle Room, the strange voice says, "Oh, I'm not sure if I'd like you to take on this challenge--you may hurt yourself, after all. But if you insist, you must know that each room contains a riddle that you'll need to solve. Solve it, and the door connecting to the next room will unlock. It's very possible that there is an end to this maze after, possibly, the seventh room. Will it lead you to safety? It looks like you'll have to find that out yourself. If it were up to me, I wish you'd just sit down...and rest...but regardless, try not to hurt yourself, heheheh." The loudspeaker cuts out.
A man stands in the center of the room in a white button-down, khaki pants, and a large name tag with the name written, "Kinder Gardener". He says as you approach him, "I really wish you wouldn't try this door, but if you insist, two plus two must equal...". There are five closed boxes in front of him, each with a button on the top that opens it.

>open box #4
You open Box #4, revealing a First Riddle Key.

A stinging pain hits your throat, and you begin to cough violently.

>unlock First Riddle Door
(with the wooden Challenge Key)
That doesn't seem to fit the lock.

>take first riddle key
Taken.

>unlock First Riddle Door
What do you want to unlock the First Riddle Door with?

>first riddle key
You unlock the First Riddle Door.

>enter first riddle door
(first opening the First Riddle Door)

Second Riddle Room
You can see a Red Door, a Blue Door, a First Riddle Door, Mindasa Gasho and Wendy Gasho here.

Two women stand side by side in the next room. To the north is a blue door, to the east is a green door, and to the south is a red door (the door you entered through is to the west). Both are dressed identically, in black button-down blouses, white sports jackets and white pants. The woman on the left has blond hair and wears a name tag that says, "Mindasa". The woman on the right has brown hair and wears a name tag that says, "Wendy." Other than these differences, both are nearly identical in every way. Both women say, perfectly in unison, "Welcome to the second room! We're so ecstatic you made it through the first riddle! It was designed for kindergarteners, so we wouldn't expect any less from you! And don't worry, this one won't be nearly as deadly if you fail. Simply FOLLOW OUR INSTRUCTIONS EXACTLY to find out which door to enter through, and you will make it to the next room in this wondrous maze!"
Mindasa recites, in such monotony that she could be mistaken for an android, "There is a zero percent chance that you'll want to follow me if your intention is to pass through to what will be the wrong room. But then again, I have been known to lie one hundred percent of the time." Mindasa then turns her back towards you and walks towards the blue door to the north. She opens it, walks through, and closes it behind her.
Wendy recites, in an identical tone and voice, "Mindasa is correct, and I will lead you to the right room room. One of these two things I just said is a lie, but this following statement is absolutely true: there is only one correct room." Wendy then turns her back towards you and walks towards the green door to the east. She opens it, walks through, and closes it behind her.

>enter red door
(first opening the Red Door)

Room of Despair
You can see a Red Door here.

>exit
But you aren't in anything at the moment.

* * *

>unlock door
Which do you mean, the Challenge Door or the True Door?

>challenge door
What do you want to unlock the Challenge Door with?

>key
(first taking the wooden Challenge Key)
You unlock the Challenge Door.

You begin to feel woozy, and your vision blurs for a second, but then you feel normal again.

>enter door
Which do you mean, the Challenge Door or the True Door?

>challenge door
(first opening the Challenge Door)

First Riddle Room
You can see a First Riddle Door, a Challenge Door, Kinder Gardener, Box #1 (closed), Box #2 (closed), Box #3 (closed), Box #4 (closed) and Box #5 (closed) here.

Once in the First Riddle Room, the strange voice says, "Oh, I'm not sure if I'd like you to take on this challenge--you may hurt yourself, after all. But if you insist, you must know that each room contains a riddle that you'll need to solve. Solve it, and the door connecting to the next room will unlock. It's very possible that there is an end to this maze after, possibly, the seventh room. Will it lead you to safety? It looks like you'll have to find that out yourself. If it were up to me, I wish you'd just sit down...and rest...but regardless, try not to hurt yourself, heheheh." The loudspeaker cuts out.
A man stands in the center of the room in a white button-down, khaki pants, and a large name tag with the name written, "Kinder Gardener". He says as you approach him, "I really wish you wouldn't try this door, but if you insist, two plus two must equal...". There are five closed boxes in front of him, each with a button on the top that opens it.

[Your score has just gone up by five points.]

>open box #4
You open Box #4, revealing a First Riddle Key.

Once again, the gas hasn't felt that impactful to your health, but your previous symptoms get stronger, and you start to sweat uncontrollably as hyperthermia takes over.

>take first riddle key
Taken.

* * *

>unlock first riddle door
What do you want to unlock the First Riddle Door with?

>first riddle key
You unlock the First Riddle Door.

A stinging pain hits your throat, and you begin to cough violently.

>enter First riddle door
(first opening the First Riddle Door)

Second Riddle Room
You can see a Red Door, a Green Door, a Blue Door, a First Riddle Door, Mindasa Gasho and Wendy Gasho here.

Two women stand side by side in the next room. To the north is a blue door, to the east is a green door, and to the south is a red door (the door you entered through is to the west). Both are dressed identically, in black button-down blouses, white sports jackets and white pants. The woman on the left has blond hair and wears a name tag that says, "Mindasa". The woman on the right has brown hair and wears a name tag that says, "Wendy." Other than these differences, both are nearly identical in every way. Both women say, perfectly in unison, "Welcome to the second room! We're so ecstatic you made it through the first riddle! It was designed for kindergarteners, so we wouldn't expect any less from you! And don't worry, this one won't be nearly as deadly if you fail. Simply FOLLOW OUR INSTRUCTIONS EXACTLY to find out which door to enter through, and you will make it to the next room in this wondrous maze!"

 Mindasa recites, in such monotony that she could be mistaken for an android, "There is a zero percent chance that you'll want to follow me if your intention is to pass through to what will be the wrong room. But then again, I have been known to lie one hundred percent of the time." Mindasa then turns her back towards you and walks towards the blue door to the north. She opens it, walks through, and closes it behind her.

 Wendy recites, in an identical tone and voice, "Mindasa is correct, and I will lead you to the right room room. One of these two things I just said is a lie, but this following statement is absolutely true: there is only one correct room." Wendy then turns her back towards you and walks towards the green door to the east. She opens it, walks through, and closes it behind her.

[Your score has just gone up by five points.]

>enter blue door
(first opening the Blue Door)

First Wrong Room
You can see a Blue Door and Mindasa Gasho here.

Mindasa says, in an almost gleeful tone, "Oh! I'm sorry! It seems you guessed...wrong..." Suddenly her eyes glow red. Your eyes start to blur, and you begin to feel dizzy. You can overhear her continue as your vision fades, "But, I'm feeling a bit merciful today! I won't kill you today! But try to return to the Second Riddle Room, and guess right this time!" You awaken moments later, back in your previous condition, in the Testing Chamber.

Testing Chamber
You find yourself in a room that takes on the appearance of a test chamber. All there is are two doors along the walls, and a small crate lying in the center of the room. On the southern wall, "1:00 AM" is painted to fill up nearly the whole wall. There is silence. Suddenly, you hear over a loudspeaker, "Ah, another test subject! Welcome! You don't know who I am, but I know everything there is to know about you." Perhaps we should keep it that way. You're objective is to get out of here and find me. How will you do that? Well, heheh, I can't tell you that. But maybe you shouldn't try to figure it out right now...maybe you should just sit down...and relax...and rest...heheheheh...oh, and just for your reference, it's currently midnight." The voice cuts out. Suddenly, you hear the audible sounds of the air ventilation system speeding up outside of the room. A strange yellow-colored gas fills the room. After some time, you feel it fill your lungs, and you cough a bit. You are left alone in the room.

You can see a Challenge Door, a True Door and a crate (empty) here.

* * *

>showme
Testing Chamber - room
    Challenge Door - locked door
    yourself - person
    crate - closed container
        *wooden Challenge Key
* denotes things which are not in scope

>open crate
You open the crate, revealing a wooden Challenge Key.

>unlock Challenge Door
What do you want to unlock the Challenge Door with?

>key
(first taking the wooden Challenge Key)
You unlock the Challenge Door.

You begin to feel woozy, and your vision blurs for a second, but then you feel normal again.

>enter challenge door
(first opening the Challenge Door)

First Riddle Room
You can see a Challenge Door and Kinder Gardener here.

>say "Hi"
(to Kinder Gardener)
There is no reply.

A stinging pain hits your throat, and you begin to cough violently.

* * *

>open True Door
It seems to be locked.

>open crate
You open the crate, revealing a wooden Challenge Key.

>take wooden Challenge key
Taken.

>open True Door
It seems to be locked.

>unlock True Door
(with the wooden Challenge Key)
You unlock the True Door.

>showme
Testing Chamber - room
    True Door - closed door
    yourself - person
        wooden Challenge Key
    crate - open container

>open True Door
You open the True Door.

>showme
Testing Chamber - room
    True Door - open door
    yourself - person
        wooden Challenge Key
    crate - open container

>enter True Door
Winning Room
You can see a True Door here.

* * *

>rest
You rest for 20 minutes. The time of day is now 12:20 am. 
 
 The strange voice exclaims, "Ah, so you've decided to take my advice...heheheh. But perhaps you should continue on your way? That illness of yours isn't waiting on you to kill you...or is it?"

>rest
You rest for 20 minutes. The time of day is now 12:41 am. 
 
 The strange voice exclaims, "Ah, so you've decided to take my advice...heheheh. But perhaps you should continue on your way? That illness of yours isn't waiting on you to kill you...or is it?"

>open crate
You open the crate, revealing a wooden Challenge Key.

>time of day
That's not a verb I recognise.

>rest
You rest for 20 minutes. The time of day is now 10:03 am

* * *

>rest
You rest for 20 minutes. The time of day is now 12:41 am. 
 
 The strange voice exclaims, "Ah, so you've decided to take my advice...heheheh. But perhaps you should continue on your way? That illness of yours isn't waiting on you to kill you...or is it?"

>rest
You rest for 20 minutes. The time of day is now 1:02 am. 
 
 The strange voice exclaims, "Ah, so you've decided to take my advice...heheheh. But perhaps you should continue on your way? That illness of yours isn't waiting on you to kill you...or is it?"

You hear gears turn. There is metal churning, string clinks and clanks to be heard. All debilitations your sickness has caused suddenly go away. The voice returns to the loudspeakers: "Well done, sir! It seems that we have another test subject that has passed and not, well, dropped dead! Why don't you come meet me in the Winning Room? You'll find that both the Silver Door and the True Door are now opened for you."

>enter True Door
(first opening the True Door)

Winning Room
You can see a Silver Door and a True Door here.

    *** As you enter this mysterious final room, you see a man of great bulk in a black suit standing in the center of the room. He wears a big smile, and in both hands he holds two peculiar documents. "Congratulations, young lad! Here's your diploma! Now walk out the exit behind me so you can get out there and tackle the real world!" Enraged that you just realized that this was meant to be a sadistic way of teaching you about thinking outside the box and following specific instructions no matter how peculiar they seem, yet powerless to do anything because you realize that you have no real sway over what just happened, you resign yourself and trudge out the back door. Congratulations, you just passed some arbitrary tests to prove your worth to a bunch of people who didn't care about you in the long run! Are you happy with yourself? ***

In that game you scored 100 out of a possible 100, in 4 turns.

Would you like to RESTART, RESTORE a saved game, QUIT or UNDO the last command?

* * *

>rst
That's not a verb I recognise.

>rest
You rest for 20 minutes. The time of day is now 12:20 am

* * *

>open Challenge Door
It seems to be locked.

>open crate
You open the crate, revealing a wooden Challenge Key.

* * *

>open challenge door
It seems to be locked.

>open crate
You open the crate, revealing a wooden Challenge Key.

You begin to feel woozy, and your vision blurs for a second, but then you feel normal again.

>take key
Taken.

>unlock challenge door
(with the wooden Challenge Key)
You unlock the Challenge Door.

A stinging pain hits your throat, and you begin to cough violently.

* * *

>shoeme
That's not a verb I recognise.

>showme
Testing Chamber - room
    Challenge Door - locked door
    yourself - person
    crate - closed container
        *wooden Challenge Key
* denotes things which are not in scope

* * *

>unlock door
(with the wooden Challenge Key)
You unlock the Challenge Door.

>enter Challenge Door
(first opening the Challenge Door)

First Riddle Room
You can see a First Riddle Door, a Challenge Door, Kinder Gardener, Box #1 (closed), Box #2 (closed), Box #3 (closed), Box #4 (closed) and Box #5 (closed) here.

A stinging pain hits your throat, and you begin to cough violently.

Once in the First Riddle Room, the strange voice says, "Oh, I'm not sure if I'd like you to take on this challenge--you may hurt yourself, after all. But if you insist, you must know that each room contains a riddle that you'll need to solve. Solve it, and the door connecting to the next room will unlock. It's very possible that there is an end to this maze after, possibly, the seventh room. Will it lead you to safety? It looks like you'll have to find that out yourself. If it were up to me, I wish you'd just sit down...and rest...but regardless, try not to hurt yourself, heheheh." The loudspeaker cuts out.
A man stands in the center of the room in a white button-down, khaki pants, and a large name tag with the name written, "Kinder Gardener". He says as you approach him, "I really wish you wouldn't try this door, but if you insist, two plus two must equal...". There are five closes crates in front of him.

>open Box #1
You open Box #1.

Once in the First Riddle Room, the strange voice says, "Oh, I'm not sure if I'd like you to take on this challenge--you may hurt yourself, after all. But if you insist, you must know that each room contains a riddle that you'll need to solve. Solve it, and the door connecting to the next room will unlock. It's very possible that there is an end to this maze after, possibly, the seventh room. Will it lead you to safety? It looks like you'll have to find that out yourself. If it were up to me, I wish you'd just sit down...and rest...but regardless, try not to hurt yourself, heheheh." The loudspeaker cuts out.
A man stands in the center of the room in a white button-down, khaki pants, and a large name tag with the name written, "Kinder Gardener". He says as you approach him, "I really wish you wouldn't try this door, but if you insist, two plus two must equal...". There are five closes crates in front of him.

    *** You died. ***

In that game you scored 0 out of a possible 0, in 5 turns.

Would you like to RESTART, RESTORE a saved game, QUIT or UNDO the last command?

* * *

>exit
But you aren't in anything at the moment.

>exit
But you aren't in anything at the moment.

You begin to feel woozy, and your vision blurs for a second, but then you feel normal again.

* * *

>f
That's not a verb I recognise.

>run
You'll have to say which compass direction to go in.

You find yourself in a room that takes on the appearance of a test chamber. All there is are two doors along the walls, and a small crate lying in the center of the room. There is silence. Suddenly, you hear over a loudspeaker, "Ah, another test subject! Welcome! You don't know who I am, but I know everything there is to know about you." Perhaps we should keep it that way. You're objective is to get out of here and find me. How will you do that? Well, heheh, I can't tell you that. But maybe you shouldn't try to figure it out right now...maybe you should just sit down...and relax...and rest...heheheheh..." The voice cuts out. Suddenly, you hear the audible sounds of the air ventilation system speeding up outside of the room. A strange yellow-colored gas fills the room. After some time, you feel it fill your lungs, and you cough a bit. You are left alone in the room.